&=> and
NASA=> national Aeronautics Space Administration,nasa
ISRO=> indian Space Research Organisation,isro
KML=> keyhole markup language is a language,kml
PSD=> photoshop document
PDF=> portable document format,pdf
AJAX=> asynchronous javaScript and xml,ajax
Oracle=> oak ridge automatic computer and logical engine,oracle
RDBMS=> relational database management system,rdbms
SQL=> structured query language,sql
XML=> extensible markup language,xml
PERL=> practical extraction and report language,perl
PHP=> hypertext preprocessor,php
ASP=> active server pages,asp
ASPX=> active server page extended,aspx
API=> application programming interfaces,api
HTML=> hypertext markup language,html
CSS=> cascading style sheets,css
ASCII=> american standard code for information interchange,ascii
GPRS=> general packet radio service,gprs
3G=> third generation,3g
GPS=> global positioning system,gps
UMTS=> universal mobile telecommunications system,umts
HSDPA=> High=> speed downlink protocol access,hsdpa
GSM=> global system for mobile communications,gsm
EDGE=> enhanced data rates for GSM evolution,edge
IMEI=> international mobile equipment identity,imei
IVRS=> interactive voice response system,ivrs
CDMA=> code division multiple access,cdma
RAM=> random access memory,ram
ROM=> read only memory,rom
MIME=> multipurpose internet mail extensions,mime
SMTP=> simple mail transfer protocol,smtp
IMAP=> internet message access protocol,imap
HTTP=> hypertext transfer protocol,http
WWWC=> world wide web consortium,w3c,W3C
DNS=> domain name system,dns
3GP=> 3rd generation protocol,3gp 
AAC=> advance audio codec,aac 
AC3=> dolby digital sound file,ac3 
AIFF=> audio interchange file format,aiff 
AMR=> adoptive multi rate,amr 
AWB=> adoptive multi rate wideband,awb
AVI=> audio video interleaved,avi  
CDA=> compact disk audio,cda 
DLL=> dynamic link library,dll 
DVD=> digital video disk,dvd 
EXE=> executable format,exe 
FLAC=> free lossless audio codec,flac 
FLV=> flash live video,flv 
GIF=> graphics interchange format,gif 
JAD=> java application development,jad
JAR=> java archive,jar 
MMF=> music mobile format,mmf 
MP2=> mpeg audio layer 2,mp2
MP3=> mpeg audio layer 3,mp3 
MP4=> mpeg audio layer 4,mp4 
MPEG=> motion picture expert group,mpeg 
PNG=> portable network/new graphic,png 
RM=> real media,rm 
SIS=> symbian installation source,sis
SWF=> shock wave flash,swf 
VCD=> video compact disk,vcd 
VOB=> video object,vob 
WAV=> waveform pcm audio,wav 
WMA=> windows media audio,wma
ZIP=> zone improvement plan,zip
WANO=> world association of nuclear operators,wano
WAY=> world assembly of youth,way
WEF=> world economic forum,wef
WFTU=> world federation of trade union,wftu
WHO=> world health organization,who
WIDF=> women's international democratic federation,widf
WIPO=> world intellectual property organization,wipo
WIPSA=> women's initiative for peace in south asia,wipsa
WMO=> world meteorological organization,wmo
WWF=> world wild life fund,wwf
WWFI=> world wide fund for nature india,wwfi
WWPA=> world wild life protection agency,wwpa
UGC=> university grant commission,ugc
UNI=> united news of india,uni
UNICEF=> united nations international children emergency fund,unicef
UNO=> united nations organization,uno
UPSC=> union public service commission,upsc
USSR=> union of soviet socialist republic,ussr
UTS=> unreserved ticketing system,uts
pix=> picture,pictr,pic
German=> germany,german
India=> indian,india
Russia=> russia,russian
Armenia=> armenian,armenia
China=> china,chinese
Nepal=> nepal,nepali
UK=> united kingdom,uk
America=> america,american
US=> united states,us
USA=> united states of aamerica,usa
Europe=> europe,europian
Asia=> asia,asian
Austraila=> austrailian
Afghanistan=> afghanistanian,afghani
Albania=> albanian,albana
Algeria=> algerian,algeria
Andorra=> andorra
Angola=> angolian,angola
Argentina=> argentina
Brazil=> brazilia
Iran=> irani,iran
Japan=> japanese,japan
Korea=> korean,korea
Pakistan=> pakistani,pakistan
Africa=> africans,africa
Arab=> arabian,arab
English=> eng,english
Language=> lan,language
Structure=> structure,str
France=> french,france
Ireland=> irish,ireland
Mangolia=> mangolian